00000000000000000003
1111110000001111114
4
4
4
4
4
4
4
4
4
4
4
4
1110000111000011104
4
4
4
4
4
4
4
4
4
4
4
4
1110101011101000104
000000000000000000
000000000000000000
000000000000000000
000000000000000000
000000000000000000
000000000000000000
000000000000000000
111111000000111111
000000000000000000
000000000000000000
000000000000000000
000000000000000000
0000000000000000004
000000000000000000
111111100000000000
000000000000000000
000000000000000000
000000000000000000
000000000000000000
000000000000000000
000000000000000000
000000000000000000
111010101000101010
000000000000000000
000000000000000000 
0000000000000000004
000000000000000000
000000000000000000
000000000000000000
000000000000000000
000000000000000000
000000000000000000
000000000000000000
000000000000000000
000000000000000000
000000000111111111
000000000000000000
000000000000000000
0000000000000000004
000000000000000000
111110000000000000
000000000000000000
000000000000000000
000000000000000000
000000000000000000
111111111000000000
000000000000000000
000000000000000000
000000000000000000
000000000000000000
111111111111111111
