1111110000001111113
000000000000000000
000000000000000000
000000000000000000
002200000000011000
000000000000000000
000000000000000000
000000000000000000
000000000000000000
000000000100000000
000000000000000000
000000000000000000
000000000000000000
1110000000011111114
4
4
4
4
4
4
4
4
4
4
4
111111100000011114
4
4
4
4
4
4
4
4
4
4
4
4
111002001100200111
000000000000000000
000000000000000000
000000000000000000
000000000000000000
000110000000022000
000000000000000000
000000000000000000
000000000000000000
000000000000000000
000000011000000000
000000000000000000
000000000000000000
100200100200100200
000000000000000000
000000000000000000
000000000110000000
000000000000000000
000000000000000000
000000000000000000
000000000000000022
000000000000000000
110000000000000000
000000000000000000
000000000000000000
000000000000000000
111100001101010100
000000000000000000
000000000000000000
000000011000000000
000000000000000000
000000000000002000
110000000000000000
000000000000000000
000000000000000000
000000010000000000
000000000000000000
000000000000000000
000000000000000000




