1111110000001111113
000000000000000000
002000000000000000
000000000000002222
000000000000000000
000011000000000000
000000000000000000
000000000011100000
000000000000000000
000000000000000000
000000000000000000
000000000000000000
000000000000000000
1110000000011111114
4
4
4
4
4
4
4
4
4
4
4
111111100000011114
4
4
4
4
4
4
4
4
4
4
4
4
210210210210210210
000000000000000000
000000000000000000
000000000000222000
010000000000000000
000000000000000000
000000000000000000
000000000000000000
000000222000000000
000000000000000000
000000000000000000
000000000000000010
000000000000000000
000111000111000111
000000000000000000
000000000000000000
000000000000000000
000000000000000000
022000000000000000
000000000000000000
000000000000001100
000000000000000000
000000000000000000
000000220000000000
000000000000000000
000000000000000000
111000111000111000
000000000000000000
000000000000000000
000000000000010000
001000000000000000
000000000000000000
000000000000000000
000000000000000220
000000000000000000
000000000000000000
000000020000000000
000000000000000000
000000000000000000







