2221220000002221223
000000000000000000
000000000000000000
000000000200000000
011000000000000000
000000000000000000
000000000000001100
000000000000000000
000000000000000000
000000100000000000
000000000000000000
000000000000000000
000000000000000000
1110000000011111114
4
4
4
4
4
4
4
4
4
4
4
111111100000011114
4
4
4
4
4
4
4
4
4
4
4
4
212000002100000221
000000000000000000
000000000000100000
000000000000000000
000000000000000000
011000000000000000
000000000000000000
000000000000000000
000000000110000000
000000000000000011
000000000000000000
000000000000000000
000000000000000000
200000100000200000
000000000000000000
000000000000000000
000000000000000000
000000000000000011
000000000000000000
022000000000000000
000000000000000000
000000000000000000
000000001000000000
000000000000000000
000000000000000000
000000000000000000
000002000001000002
000000000000000000
000000000000000000
000000000000001111
000000000000000000
000000000000000000
001100000000000000
000000000000000000
000000000000000000
000000000000000000
000000000000000000
000000011000000000
000000000000000000